00000000
00000000
00100100
01000000
01000100
01111000
00000000
00000000