00000000
00000010
00000000
01110000
00000000
00000000
00000000
00000000